1111111111
1000000001
1000000001
1110000111
1111111111